Amino_Acid	Three_letter_Code	One_letter_Code
ALANINE	ALA	A
CYSTEINE	CYS	C
ASPARTIC ACID	ASP	D
GLUTAMIC ACID	GLU	E
PHENYLALANINE	PHE	F
GLYCINE	GLY	G
HISTIDINE	HIS	H
ISOLEUCINE	ILE	I
LYSINE	LYS	K
LEUCINE	LEU	L
METHIONINE	MET	M
ASPARAGINE	ASN	N
PROLINE	PRO	P
GLUTAMINE	GLN	Q
ARGININE	ARG	R
SERINE	SER	S
THREONINE	THR	T
VALINE	VAL	V
TRYPTOPHAN	TRP	W
TYROSINE	TYR	Y
